111110011111111110011111
100000000001100000000001
100000000001100000000001
100000000001100000000001
100000000001100000000001
000000000000000000000000
000000000000000000000000
100000000001100000000001
100000000001100000000001
100000000001100000000001
100000000001100000000001
111110011111111110011111
111110011111111110011111
100000000001100000000001
100000000001100000000001
100000000001100000000001
100000000001100000000001
000000000000000000000000
000000000000000000000000
100000000001100000000001
100000000001100000000001
100000000001100000000001
100000000001100000000001
111110011111111110011111